Population.code	Superpopulation.code
STU	SAS
BEB	SAS
PJL	SAS
MSL	AFR
ITU	SAS
CEU	EUR
GBR	EUR
YRI	AFR
FIN	EUR
CHB	EAS
JPT	EAS
CHS	EAS
PUR	AMR
LWK	AFR
CDX	EAS
CLM	AMR
MXL	AMR
IBS	EUR
PEL	AMR
ASW	AFR
KHV	EAS
TSI	EUR
GIH	SAS
ACB	AFR
GWF	AFR
GWJ	AFR
GWD	AFR
GWW	AFR
ESN	AFR
